########################################
#                                      #
#                                      #
#                                      #
#                                      #
#                                      #
#                                      #
#                                      #
#                                      #
#                                      #
#                                      #
#                                      #
#                                      #
#                                      #
#                                      #
#                                      #
#                                      #
#                                      #
#                                      #
#                                      #
#                                      #
#                                      #
#                                      #
#                                      #
#                                      #
#                                      #
#                                      #
#                                      #
#                                      #
#                                      E
#                     @    @           E
#   ^^      ^^^^^     #    #      ^^^  E
#GGGGGGGGGGGGGGGGGGGGGGGGGGGGGGGGGGGGGG#
#DDDDDDDDDDDDDDDDDDDDDDDDDDDDDDDDDDDDDD#
#DDDDDDDDDDDDDDDDDDDDDDDDDDDDDDDDDDDDDD#
########################################
