####################################
#                                  #
#                                  #
#                                  #
#                                  #
#                                  #
#                                  #
#                                  #
#                                  #
#                                  #
#                                  #
#                                  #
#                                  #
#                                  #
#                                  #
#                                  #
#                                  #
#                                  #
#                                  #
#                                  #
#                                  #
#                                  #
#                                  #
#                                  #
#                                  #
#                                  #
                                    
      @      @     @                
C     <>     <>    <>      ^^       
GGGGGGGGGGGGGGGGGGGGGGGGGGGGGGGGGGGG
DDDDDDDDDDDDDDDDDDDDDDDDDDDDDDDDDDDD
DDDDDDDDDDDDDDDDDDDDDDDDDDDDDDDDDDDD
