####################################
#                                  #
#                                  #
#                                  #
#                                  #
#                                  #
#                                  #
#                                  #
#                                  #
#                                  #
#                                  #
#                                  #
#                                  #
#                                  #
#                                  #
#                                  #
#                                  #
#                                  #
#                                  #
#                                  #
#                                  #
#                                  #
#                                  #
#                                  #
#                                  #
#                                  #
                                    
      @      @     @                
 C    <>     <>    <>      ^^       
GGGGGGGGGGGGGGGGGGGGGGGGGGGGGGGGGGGG
DDDDDDDDDDDDDDDDDDDDDDDDDDDDDDDDDDDD
DDDDDDDDDDDDDDDDDDDDDDDDDDDDDDDDDDDD
