####################################
#                                  #
#                                  #
#                                  #
#                                  #
#                                  #
#                                  #
#                                  #
#                                  #
#                                  #
#                                  #
#                                  #
#                                  #
#                                  #
#                                  #
#                                  #
#                                  #
#                                  #
#                                  #
#                                  #
#                                  #
#                                  #
#                                  #
#                                  #
#                                  #
#                                  #
#                                  E
#     @      @     @               E
#     <>     <>    <>      ^^^     E
GGGGGGGGGGGGGGGGGGGGGGGGGGGGGGGGGGGG
DDDDDDDDDDDDDDDDDDDDDDDDDDDDDDDDDDDD
DDDDDDDDDDDDDDDDDDDDDDDDDDDDDDDDDDDD
